nōn - не
iam - сега (вече нещо се е случило, нещо е така)
nunc - сега (нещо се случва)
rūrsus - отново, повторно
tantum - само
ecce - ето
satis - достатъчно
nimis - прекалено, предостатъчно
tunc - тогава
adhūc - засега, досега 
deinde - после, след това
hodiē - днес
statim - веднага, на момента
vix - едвам
simul - по същото време
iterum - повторно, отново
cotīdiē - всеки ден
una ... cum ... - едновременно с
heri - вчера
crās - утре
subitō - внезапно
forte - незнайно защо, безцелно
haud - не, хич не
dēnique - накрая
quasi - като
inde - откъдето
diu - задълго
paulisper - закратко
dēmum - най-сетне
prīdem - одавна
ideō - затова
donec - докато
ubique - навсякъде
iūre - заслужено, наистина
ferē - около, горе-долу
ūsque - все, винаги, изцяло
dumtaxat - само, единствено, точно
potius - по-точно, по-скоро 
funditus - напълно, изцяло
cōram - в присъствието на 
